NO textures/polarbear_north.xpm
SO textures/Pinguine_South.xpm
    
WE textures/eagle_west.xpm
EA textures/Tiger_east.xpm


F 010,100,10
C 51,198,227
1111111111111111111111111
1000N00011000000000000111
1011111011110000000000001
1000000000000000000000001
111111111011000001110000111111111
100000000011000001110111111111111
111101111111111111000000111111
111101111111110111010100111111
110000001101010111000000111111
100000000000000011000000111111
100000000000000011010100111111
1111011111010101111101111000111
11110111 1110101 100000000001
11111111 1111111 111111111111