NO textures/polarbear_north.xpm
SO textures/Pinguine_South.xpm
    
WE ./textures/eagle_west.xpm
EA                  ./textures/Tiger_east.xpm


F 010,100,1
C 51,198,227
        1111111111111111111111111
        1000000000110000000000001
        1S11000001110000000000001
         1000000000000000000000001
111111111011000001110000000000001
100000000011000001110111111111111
11110111111111011100000010001
11110111111111011101010010001
11000000110101011100000010001
10000000000000001100000010001
10000000000000001101010010001
11000001110101011101111001011
11110111 1110101 101111000001
11111111 1111111 111111111111