NO textures/polarbear_north.xpm
SO textures/Pinguine_South.xpm

WE                textures/eagle_west.xpm
EA textures/Tiger_east.xpm


F 184, 113, 39
C 51, 198, 227

111111111111111111111111111111111
11111S001111111111000000000001111
111100011111111110000000000000111
111000111111111111111111100011111
110001111111111111111111000111111
110000000000111111111110001111111
100000000000111111111100011111111
111100011111111111111000111111111
111100011111111111110000000000001
11110001111111111110000000000001
1111111111111111111111111111111