NO textures/north.xpm
SO textures/south.xpm
    
WE textures/west.xpm
EA textures/east.xpm   

F 184,113,39
C 51,198,227
11111
10W01
10101
10001
11111